-0,1874 0,0092 -0,9822 -1,6699 
0,0000 1,0000 0,0094 0,2000 
-0,9823 -0,0018 0,1874 0,4945 
0,0000 0,0000 0,0000 1,0000 

50,0000 0,0000 500,0000 0,0000 
0,0000 50,0000 500,0000 0,0000 
0,0000 0,0000 1,0000 0,0000 
0,0000 0,0000 0,0000 0,0000 

1000
1000
0,3
1000
