-0,7290 0,0064 -0,6845 -1,1637 
0,0000 1,0000 0,0094 0,2000 
-0,6845 -0,0069 0,7289 1,4152 
0,0000 0,0000 0,0000 1,0000 

50,0000 0,0000 500,0000 0,0000 
0,0000 50,0000 500,0000 0,0000 
0,0000 0,0000 1,0000 0,0000 
0,0000 0,0000 0,0000 0,0000 

1000
1000
0,3
1000
